0000000000000000000000000000000000000000000000000000000000000000000000000000000
0111011111111111110101011111111111111101010111111111111110111110111111111111101
0001000100000000010101000000010001000101010000000100110010100010001000000000101
0101011101111111011101111111010101110101011111110111111110111010111011111110101
0101010001000001000100000001010100010101000000111111001111101010100010000010001
0101010101011101011111011111010111010111110111111111111111101010101010111010111
0101010101010101010001010000010100010001010100000110001100101010101010101010100
0101110111010111010101110111010111011101011111110111111111101011101110101110101
0100000000010000010101000001010001000100010000111100110010001000000000100000101
0111111111010111010101011111011101110111111111111111111111111111111110101110101
0100000001010101010101010000000101000001010100000011110000001000000010101010101
0101111101110101110101010111111111011111010101111111111111101011111011101011101
0100010100010100000101010100000000010001011111000000001100101000101000101000001
0111010111110101111111110111011111110111111111111111111111111110101111101011111
0101000001000100000001010001010000000100011100111100000010001010000010001010000
0001111101011101111100011111011101111101011111111111111010101011111010111011111
0100000100010000000101000000000101010101010000000011111011101000001000100000001
0111110111010111111111110110111101010101011111111111111110101111101110101111111
0000010001010100000100010100000001010101000101000000111010100000100010101000001
0111111101111101111101111101011111010101111111111111111111101111111011111011111
0000010001000000000100000000010000000001000100000100000000100000001010000010000
0111110111110111111111011111111111110111010111111111111111111111101011101111111
0100000101010001000001010000000001000100011100000000110010110000001010100010000
0111111101011101111101110111111101110101010101111111111010101111111010111011111
0100000001000100000101000100000100010101010011000011001110101000000010001000001
0111110111010111110101110101110101010101111111011111101010111111101110101111101
0000010100010000010100010101010101010101001111011111101111100000001000100000103
0111110101111101011111010111010111011101110101111111111110101111101011011010111
0100000101000101000001010000010001000001011100001100000000101000001010001000000
0101110101110111110101010111010111111111010111111111111111101011101010101111111
0101010101010000000101010101010100000001010111111111000000101010101010100000001
0101011101011111111101011101011101110111011111111111111111111010111010111111111
0101000001000000000101000001010001010000010000111100101100001010000010000000001
0101011101011101110101111101011111010111111111011111101111111010111010111011101
0001010101010101010100000001000100000100001011011011000010100010101010101010101
0111010111010101010111111101110101111101011111111111111110101110101110101010101
0100010001010001010101100011010101000011110000000000000000000000100000101110101
0111011111110111010101111111010111011111111111111111111111111110111111101110101
0101111111111101010111101101010101111111111111111111101111111011111111101000111
0101111111111111011111111101011101111111111111111111111111111011111111111110111
0111010111111000110101111111011111011111011111111111100111101111001111111010111
0111110111111101111101111111011111011111011111111111111111101111101111111010111
0111011111110101010101111101110101111111011111111111111111111110111111101010101
0111011111110101010101111101110101111111011111111111111111111110111111101010101
0101111101110111010101011111010111011111010111110111101111101011111011101110101
0101111101110111010101011111010111011111011111111101111111101011111011101110100
0101011101111111011111110101111101011111111101011111111111111110111011111110111
0101011101111111011101110101111101011111111101111111111101101110111011111110101
0101011111111101111101011111011101011101010111111111111110101010111111111011111
0101001111110101101101011111011101011101010110111111111110111010111111111011011
0101111101110111011111111111110101110101011111111111111111101011111011101110111
0100100101110101010101111111100101100101011111111011011010111011111010101010101
0111011101011101110101011101110101110101010111111110111111101110111010111011101
0101001001010101100101010101010101110101010111111111111110101110000010100010101
0101111101011101011101010101010111010111010111111111111111111011111010111010111
0000000101010001010101010101010000010001011101001100001111110000001010100010101
0111111101010111010101010111011111110111110101110111111111101111111010101110101
0100000001010000010100010001000000000101000100010000000011101000000010001000101
2111111111011111110111110111111111111101011111111111111110101011111111111111101
