111111111011111011111011111111111
100000001010000010001010000000001
101111111010111111101011111111101
101000000010100000101000000000101
101011111110111011101111111110101
101010000000001010000010000010101
101010111011111011111010101010101
101010101010000000001010101010101
101110101010111111101010101011101
100010101010111111101010101010001
111010101010111111101010101010111
001010101010111111101010101010100
111010101010111111101010101010111
100010101010111111101010101010101
101110101010113111101010101010101
101010101010001000001010101010101
101010101011101011111010101110101
101010101000101010000010100000101
101011101110101011111111101111101
101000000000101000000000000000001
101111111111101111111111111111111
100000000000000000000000000000000
111111111111111211111111111111111