000000000000000000000000000000000000000000000000000000000000000000000000000000000000
010111111101111110111101111111111011110111111011110111101111111111011101111101111110
011000100101000010000100101000010010011100001000010000101000000000110100000101001010
000010000000001010010100100101001000100001100011010000000000011010000100001100010010
010111101111001110110110111001111110111101111111110110111111001011011101101011110110
010000100001000011000000000000010010100101000000010010100100001001010000101000000000
010110110111011011011100111111011110111101111011110110100111001011011101101101111010
010000000100001000010100101000000000100001001000000000101001001010000100000101000013
010010000101101010000100101101000000010101100001010010001101001000010100100001010010
010011110101011010110101101001011110110101111001110110110101101011010111101101011010
010000000101000010010100101000010010100100000001000000100100101001010000001001010000
010110111101011111010110101011111110110111111111111110110111101111010111101011110110
010011100001000110010001101000001000010001101000000000010100001000010000101000000010
000000000001001000000000100100010000000101100110010100000001000010000100100000010000
011111100111001110110110111011111110111101101111011111101111011010111101101111110110
010000100100000010010100001000001010010100001000000010100100001000000000001000000010
010110110111011110011101111011111011110111101011111010110111111111011111111011011010
000010000011000000010010000010011000000011101010010100011001000000010100100001000010
010000100000001001000100101001000000010000100011000000000001010000000010001000010010
011010101101011010110111101011011111110111111011111111111111011010111111101111111110
000010100101000010010000001100010000000101001000010000000000001010000000000000000000
010010110101011010110110111101011110110101101111110110111111001110110110111111111110
011010001101001011011100100001011000110000100000000010100001000010010100100000110010
010000100000000010000000001101010000000101100011010000100100000010000100101001000000
010110111101111010110101111001011110111101111111110110101101011011111101101001111110
010010100101001010010100000001000010100001000000010010000101001000000000101000000010
011010110101101010011101101101011110110111111011110011111101001110110110101101110010
000010010100101110100110111001001000100101001000000100000001010010010000000001011010
010010100101000000010100000000000010010100100011010010100000000010000100101001000010
010010101101111011010101111001111110110111111001011110111101111110110100101001011110
010010100000001010010100001001010010100001000011000000010101001000000100101101010000
010010110111111010110101101001011010110111111101111011110101001011011100101101011110
010011111111001110111101101001111111111101101111111110110101011010010110101011011110
010000000001001010000000001001000000000001000010000000010101000010010100101000010010
010111110111011010011101101011011110110111111011011111111101011010110101101011110110
010000100100000010010100101100010010110001101001000010000001001010000110001000000000
010011100111011110110110101101111111111101101011111011111111011010110111111101110010
011010111101111011011110111101011011100111101011110111100111111110010110111001111010
000010000101000010000100100001011010110001001000000110100001010000010000100000000010
011110110101011110111111101011011010110101111111111110101101011111010110101111011110
010000100100000000000000101101000010110101101000000010100100001000000101101001010000
010010100111011011011110101101111010110101101111110110110111111011111101101001010110
011011100111101010110110101111111010111101101001011110110111111110111101111001111110
010000000100101010000100001000000010110000101011000010100100000000000100000000000000
011111101101111010110111101111111011111111101011110110100101111011011111111011011110
001000100001000010000000100000011000010000001010010110101101001010010000001001010010
011010101101101100010110101101011011101111111011010110100101001010011010111101011010
011010110111001110110110111011011010111101101011110011101101001111011100111011110110
001010000001000010000010101000010010110001101000010010001001000000010100001000000010
011011101101111110011110101101011010110111101011010010111111001111010111101001111010
010000100100000000000100000001011010000100101001010110101000001000010000101101000010
001110100001010010010000011001010010111101001001010010100110001010010110000001010010
011010110111011011011101101101011010110111111011010111111101101011010101111101010110
010000000101001000000100100001001010100000000010010100000101001000010000001001010000
010110111101101110111100111011011011111111111111110111111111001110110111111111010110
010010010000000010000010001101111000100100000011000010011000010010000100000000010010
011010000101001010010000100101001010010101101010010100100001011010000101000111010110
010011111101101011010110101101111010111101111011010011111101001010110101101111110010
000010000000001000010100101000011010100101101001010000000101001010010100001000000000
011011101101101110110101101011011110110101101111011110111101001110010101101011110110
010000110111000010000100001001000000000100001000000010101101010000010000111001000010
011110000000001010000000000000111110110011101010001010100001000010000000000010011010
010011101101001011011111101111011011111111101011110110101101111010111111111101110110
000000100101001000010000100001000000000000101000010000100100001010000000100001000010
011011100101011011011110111001011110111111111011110110101111101111011110101101110110
010010000101000010000000001011010010100001000000011000100000100000010100001000010000
001000101001011010010100101010010010110000100001000010001100001001010100000001000010
011110101101001010110110101011111011110111111111110111111111101010010111101111011010
010000100001001010000000100000001000110101000010010010000000101010010000001001000000
010110110111011011011110111111111110110101111001110111111111101010010111111001110110
011010000100100000010000001000010010110101101111000000010100001011010100001000010010
000010001101101010010100001000001000010100000001000000000101000000010011101000000010
011110110101001011110110111001111011110111111111110111100101011011010110101111011010
010010100101001000010000100001000010110001100000010000100101000010010100100000010010
010110110111011011011100111001111010110101101111010110100111001110110110111011110110
010000010000001010000110001000000010000101001000010010110000001000000000001000000000
001010000001101010000100101001000000110100100001000100000100000001010101000000000010
011010110111011011011101101101111110110111111001110111111101111011010100111111110110
010010100100000000010100000000001010100001001000010000000001001010010100101000000000
010111100111101110010100111011011011111101101111011111111111011010110101101111011010
010000001000001010010110101001010000010101101001010010010100001011000100100001010010
010010000101000010010010001000000010100101101010000000100001000001010001001001001010
011011111111011011011101111011111110110111111111111110111111011111011101101101111110
000000000000000000000000000000000000000000000000000000000000000000000000000200000000
