00000000000000000000000000000000000000000
01111111110111110111111101111111111111110
00000100010101000101000101010000000000010
01110101110101111101011101011111111101010
01010001010100000001000001000000000101010
01011101010111011101110111010111110101110
01000101010001010100010100010101010101000
01110101011101010111110101111101010101110
01010101000001010000000101000001010100010
01010101111101011101111101111101010101110
01010100010101000101000000000101000101000
01010111010101110111011111011101110101010
00010001010100010000010100010000010101010
01110111010111111101110111110111110101110
01000001000000000100010000000100010100000
01011101111111011111010111111101110111110
01010100000001000001000101000000000000010
01110111110101111101111101011101111111110
00000000010100000100000000010101000000010
01111111110111011101111101110111010111110
01000000000001010001000101000000010100000
01010111011111011111010101111101111111010
01010101010100000000010101000100000001010
01011101110111110111011101110101111101010
01000100000001000101010000010101000101010
01110101011101111101110111010111010101110
01010101010100000000000101010000010100000
01010101010111111111110101111111010111110
00010101010001000000010000000001010000010
01110101110111011111011111110101011101110
01000101000100010100000000010101000101010
21010101011101110111110111010101110101010
00010100010000000101010001010100010101010
01110111110111110101011111010111011101013
01010000000101010001000000010100000101000
01011111110101011111011101110111111101110
01000001000101000100010101000001000000010
01110111011101110101110101111101011111010
00010100010000010001000100000100010001010
01110111111111011111110111111111110111110
00000000000000000000000000000000000000000
