000000000000000000000000000000
011011100001110111001101011101
010000000100100010000000100001
010011100000001100110011010101
001111100100010001001100011111
011101000111011000000100011101
000110000100010001001000000000
010101011101000011100110110011
000010000100111011100100010001
010001000100000100001100010001
010010000001011011011001100001
011001100101000001010101010101
000000000010011011101000110001
011001011111000000000111011001
011101000000010101010100011001
010111000110101001100101111001
010001001110000001000000110000
001101000101011001010111111001
010011000010110101000110000001
011001100110101111011101110001
011000000111111001100100011011
011101100110000001100111011001
011001000110011001100100010011
011000000110011001100011110001
010001001000010111101111010001
011101110101111100011110110001
011001000010100001000000001001
011011111110010101011110110101
001001000101010101011101011001
010111011101011111111111111111
