0200000000000000000
0101111111111111110
0101000101001100000
0111011101111111110
0100010000010001010
0101110111111101010
0100000100100100010
1111011111110101110
0010010010010101010
0111010111010101010
0001010101010101010
0111011101010111010
0100010001010000000
0111111101011101110
0000010101010000010
0111010101110111010
0101010100100101010
0111110111111101113
0000000000000000000