00000000000000000000000000101000001001100001010001
01000100110100000000110010100010100000101111111001
01100101001100100100001100100010000001001011001010
01000100000000000000000000010110000000001100110101
00000000000111101000000000000000000000011111110111
00001000100000100000001001111000100010101110111110
01000100010001000000000100000000000000001011111011
00000000000000000000000000000000000010010101100101
00010001000000100100000001100110000000001111000011
00101100000001000000010011010001000100001010001101
01000001010010100010110010110000100010001111101110
00001010010010101010000000000000000000010001010101
01010000001011101000000001000000000100001000111101
00001000000010100000100000100000010000010101101111
00100001001000000010000110001000110001000101110111
00000000010000100000000001000000010000000110111101
00000100000000001101000000000011000000001110001111
00000000000000100110101010100001011101001110111111
00110000000000100100000100011011101010001111111111
00000010000001000010110010100000000000000100110010
00010110000010001000001000011110010001001111010011
00000100000000000011100000000000010000000000111101
00000010000000000000010101000101000100010100111011
00000000001000000000000000100000000010010010111000
00000001000001100010101010011010010011011111110111
00000000000100001010000010000000010101000101101101
00000000000011000010110100001001000000011111110111
01010000000000100010001010000000100100011111111010
00010010001010000000001000010000110011000101110001
00000100010000100011000000000000000000001110111011
00010000000000000100110001000000000000001100100111
00000000001000000000000100100000000000000111101111
00100100010001100110110100100000010100001110110011
00000001010000000010010000000001110100100111110011
00010000000000001010001010001000010000011101011101
00010000001110000000110000101101100010001111011111
00100000000000000110111000000001000001001101101111
00000010000000100011000000100001000000101111111111
00000010000000100000000011000011100001001101111101
00000010010000101010100011011101001100111111110110
01110000101110101010111110100001101100101111111111
01010000101010101110101101110111100000011111111111
00000000010111110111111000111100100111001111111111
00010000110011110011110111110010110110101111111111
01101000010010100100111101110111100010111111111111
01011001011010110110101111100011000100101111111111
00011110010100100010111101100010000011101111111111
00101010111101101011110111011101111101111111111111
00000100001011000111101111011111011101001111111111
00111010111110111111111111111111111111011111111111
